{
	"name": "level_1",
	"author": "Markus",
	"texture": "__CONVERTED_level_1.png",
	"x": 3,
	"y": 5,
	"x2": 4,
	"y2": 5,
	"character": "ά",
	"character2": "^",
	"bulletl": "\\",
	"bulletr": "1",
	"finish_x": 36,
	"finish_y": 5,
	"finish_x2": 36,
	"finish_y2": 5,
	"high": 12,
	"wide": 8,
	"gravity": 0,
	"jump": 0,
	"data": [
		"########################################",
		"###### -?@!@.,δυό,~|δ><_δ:δ;¤,-%&ό/#####",
		"#(-¤%δ)-ό/δ&=δ,-δ)@,δ,-δ,|@δ£&.&=|δ/&.@#",
		"#/ό$@/@€δ{<#############################",
		"########################################",
		"###[################################{###",
		"########################################",
		"#]@@}δ!-?&.)δ%&)|,δ¤.,&/δ*-¤δ)@,δ,-δ,|@#",
		"#£&.&=|δ/&.@<###########################",
		"########################################"
	]
}